NO ./res/netflix.xpm
SO ./res/samsung.xpm
WE ./res/walmart.xpm
EA ./res/ebay.xpm

F 141,105,63
C 69,216,253
1111111111111111111111111
100000000011000001000000d1
10000001110000000d0000001
10010000000000000100000001
11111111D1110000011100001
100000000011111111110111111111111
 111111011111110111000000100011101
1111011D111111011101010010001110D1
1100000011010101110000001000111111
1001000000000000d000000010001
10000000000000001101010010001
110N00111010101111101111001111
11110111 111010101111010001
11111111 11111111111111111
