NO ./res/netflix.xpm
SO ./res/samsung.xpm
WE ./res/walmart.xpm
EA ./res/ebay.xpm

F 141,105,63
C 69,216,253
1111111111111111111111111
100000000011000000000000d1
100000011100000000E000001
10010000000000000000000001
1111111110110000011100001
100000000011000001110111111111111
 111111011111110111000000100011101
1111D110111111011101010010001110D1
110d0d0011010101110000001000111111
1001D100000000001100000010001
10000000000000001101010010001
110000111010101111101111001111
11110111 111010101111010001
11111111 11111111111111111
