
NO ./res/north.xpm
SO ./res/south.xpm
WE ./res/west.xpm
EA ./res/east.xpm

F 220,100,0
C 225,30,0

1111111111111111111111111
1000000000110000000000001
10010000000000000000000011
1111111110110000011100001
1100000N0011000001110111111111111
1011011111110111000000100111
11110110111111011101010000001
1000000101010111000000100011
1001D100000000001100000010001
10000000000000001101010000101
1100001110101011111111100001
11110111 1110101 10111100111
11111111 1111111 11111111111
