NO ./res/netflix.xpm
SO ./res/samsung.xpm
WE ./res/walmart.xpm
EA                ./res/ebay.xpm

F 220,100,0
C 225,30,0
1111111111111111111111111
100000000011000000000000D1
1000000111000000000000001
100100000000000000E0000001
1111111110110000011100001
100000000011000001110111111111111
 111111011111110111000000100011101
1111D110111111011101010010001110D1
110d0d0011010101110000001000111111
1001D100000000001100000010001
10000000000000001101010010001
110000111010101111101111001111
11110111 111010101111010001
11111111 11111111111111111
